*XXXXXXXXXXXXXXXXXXX
***X*******X***X***X
XX*X*XXX*X*X*X*X*XXX
***X*X***X*X*X*X***X
*XXXXX*XXX*X*X*XXX*X
***X***X*X*X*X***X*X
XX*X*XXX*X*X*XXX*X*X
*X***X*****X***X***X
*XXXXX*XXXXXXX*XXX*X
***************X****