*XXXXXXXXXXXXXXXXXXX
*X*********X*****X*X
*X*XXX*XXX*X*XXX*X*X
*X***X***X*X***X*X*X
*XXXXXXX*X*XXX*X*X*X
*X***X***X*****X*X*X
*X*X*X*XXXXXXXXX*X*X
***X*X*X*******X***X
XXXX*X*X*X*XXXXXXX*X
*******X*X**********